O PT  T      T  T  O
 PC   T      T T CP 
PT   TT          TP 
S   CP   P    PC    
           P  P     
     B              
    CP  P P   PC     
PT   T       TT   T 
 PC   T          CP 
O PT  T      T T P O