OC T          T  CTO
  P         TC PP   
T C T         TTT PT
     B              
        TP PT       
        P S P   CCTT
P    T  TP PT  TP   
CP  PT    P    T   P
   TC  T       T   C
O  T P         T P O